Vocabulaire : 

Question - 질문
École - 학교
Lycée - 고등학교
Université - 대학교
Lieu - 장소
Homme - 남자
Femme - 여자
Mariage - 결혼
Se marier - 결혼하다
Revoir / faire des révisions - 복습하다
Enseigner - 가르치다
Aller (régulièrement) - 다니다
Quoi - 무엇을 
Hôtel - 호텔
Une bibliothèque - 도서관
Anniversaire - 생일
Salle de sport - 헬스클럽
Une fête - 파티
Demain - 내일
Aujourd’hui - 오늘
Piscine - 수영장
Nager - 수영하다
Fruit - 과일
Ici - 여가
Sac - 가방
Où - 어디
Chaussures - 신발
Magasin - 가게
Acheter - 사다
Que/quoi - 뭐
Faire - 하다
Oui - 네
Non - 아니요
Maintenant - 지금
Alors - 그럼
Déjeuner - 점심 ( on peut l’utiliser pour remplacer le nom du plat) 
(Conjonction) Et - 그리고
Le suffixe 들(deul) pour souligner le pluriel même si il peut,  ne pas 
être obligatoire en fonction du contexte 


Expressions :

Ça fait longtemps que l’on ne s’est pas vu - 오랜만이에요
Ah bon ? - 그래요 ?
Aller et rentrer bien -다녀와요 -> forme infinitif : 다녀오다

